R 1000 1000
NO    textures/mossy.xpm

SO    textures/colorstone.xpm

WE    textures/greystone.xpm

EA    textures/eagle.xpm

S     textures/pillar.xpm

F 220,   100   ,   2
C 225,    30,  3


11111111111111111111111
100000S2000000000000001
100000002100000000000001
10000000000000000000001
10000000000000000000001
100000000000000000000011
10000000020000000000001
100000000000000000000011
10000000000000000000001
10000000020000000000001
10000000000000000000001
11111100000000000000001
     10000000000000000111
111111000000000000000001
10000000000000000000001
10000000000000000000001
10000000000000000000001
10000000000000000000001
10000000000000000000001
10000000000000000000001
10000000000000000000001
11111111111111111111111
